5x4
3,0
4,0
 _ _ _ _ _ 
|      _| |
|  _      |
|         |
|_  |_ _ _|