8x8
1,6
1,7
 _ _ _ _ _ _ _ _ 
|          _    |
|_      |     | |
|       |     | |
|  _ _  |     | |
|   |      _  | |
|   |     | |  _|
|  _ _          |
|_ _ _ _ _   _ _|