8x8
4,4
5,0
 _ _ _ _ _ _ _   
| | | |  _  |_  |
|_ _         _ _|
|_    | |_    | |
|   |_  |  _| | |
|   |     | |_| |
| | |  _     _ _|
|     |   |_ _  |
|_|_ _ _|_ _ _ _|