8x8
5,3
0,6
 _ _ _ _ _ _ _ _ 
|_ _ _  |       |
|    _   _| |_  |
|  _|    _|  _  |
|     |_|   |   |
|  _   _        |
| |_ _      | | |
|        _    | |
|_ _|_ _ _ _   _|