8x8
5,2
2,4
 _ _ _ _   _ _ _ 
|_  |  _ _|  _  |
|  _|_ _  |  _| |
|   |   |   |_  |
|  _      | |  _|
|   |_|_|      _|
|       |_ _|   |
|_  |           |
|_ _ _ _ _ _|_ _|