8x8
5,2
1,2
   _ _ _ _ _ _ _ 
|_   _|  _ _  | |
|   |     | | | |
|   |      _| | |
|      _    |   |
|_ _    |_| |_  |
|      _ _|   | |
|_ _|  _  |     |
|_ _ _|_ _ _ _ _|