8x8
4,0
0,6
 _ _ _ _ _ _ _ _ 
| | |_ _  |_   _ 
|    _ _ _|_   _|
| | |_ _   _   _|
| |  _   _|_  | |
| |  _|_ _     _|
|_|_    |_ _|   |
|  _ _|       |_|
|_ _ _ _ _|_ _ _|