8x8
6,2
1,0
 _ _ _ _ _ _ _   
|       |  _ _  |
| | | |    _ _  |
|_ _ _  |    _| |
| |     | |   | |
|  _ _| | |_  |_|
|_   _  |   |  _|
|  _|   |   |_  |
|_ _ _ _ _|_|_ _|