8x8
3,0
3,5
 _ _ _ _ _ _ _ _ 
|     |       | |
| |_   _| |     |
|_  |  _ _   _| |
|   |  _  |_   _|
| | | |   |_   _|
| | |    _  |   |
|  _| |  _    | |
|_ _ _ _ _ _|_  |