8x8
0,4
1,0
   _ _ _ _ _ _ _ 
| |      _      |
|       |  _| | |
|  _|  _ _ _  | |
|_|_ _ _   _  | |
|_   _  |  _    |
|_   _ _        |
|_ _|   |   |_  |
|_ _ _|_ _ _ _ _|