8x8
7,3
6,7
 _ _ _ _ _ _ _ _ 
|  _      |  _ _|
|   |   |_ _|  _|
|    _     _   _|
|    _  |_ _ _ _|
| |  _ _ _   _| |
| |  _      |   |
| | |  _|       |
|_ _ _ _ _ _ _| |