7x8
4,6
0,7
 _ _ _ _ _ _ _ 
|    _ _      |
| |       | | |
| |_      | | |
| |  _ _  | | |
|   |_ _  | | |
|         |_  |
|           | |
|_ _ _ _ _ _ _ 