8x7
5,2
2,2
 _ _ _ _ _ _ _ _ 
|    _     _    |
|   | |   | |   |
|   | |   | |   |
|       |        
|    _ _ _ _    |
|         |_|   |
|_ _ _ _ _ _ _ _|